2
0 8 0 20 6 4
8 12 20 120 6 4
12
256 192 288 160 4 1 1 45
288 160 352 160 4 1 1 0
352 160 384 192 4 1 1 45
384 192 384 256 4 1 1 90
384 256 352 288 4 1 1 45
352 288 288 288 4 1 1 0
288 288 256 256 4 1 1 45
256 256 256 192 4 1 1 90
288 256 352 256 6 1 4 0
352 256 352 192 6 1 4 90
352 192 288 192 6 1 4 0
288 192 288 256 6 1 4 90

288 48 30 0 0
